50 50
20 20
83 86 83 86 83 86 83 86 83 86 83 86 83 86 83 86 83 86 83 86 83 86 83 86 83 86 83 86 83 86 83 86 83 86 83 86 83 86 83 86 83 86 83 86 83 86 83 86 83 86
83 86 83 86 83 86 83 86 83 86 83 86 83 86 83 86 83 86 83 86 83 86 83 86 83 86 83 86 83 86 83 86 83 86 83 86 83 86 83 86 83 86 83 86 83 86 83 86 83 86
83 86 83 86 83 86 83 86 83 86 83 86 83 86 83 86 83 86 83 86 83 86 83 86 83 86 83 86 83 86 83 86 83 86 83 86 83 86 83 86 83 86 83 86 83 86 83 86 83 86
83 86 83 86 83 86 83 86 83 86 83 86 83 86 83 86 83 86 83 86 83 86 83 86 83 86 83 86 83 86 83 86 83 86 83 86 83 86 83 86 83 86 83 86 83 86 83 86 83 86
83 86 83 86 83 86 83 86 83 86 83 86 83 86 83 86 83 86 83 86 83 86 83 86 83 86 83 86 83 86 83 86 83 86 83 86 83 86 83 86 83 86 83 86 83 86 83 86 83 86
83 86 83 86 83 86 83 86 83 86 83 86 83 86 83 86 83 86 83 86 83 86 83 86 83 86 83 86 83 86 83 86 83 86 83 86 83 86 83 86 83 86 83 86 83 86 83 86 83 86
83 86 83 86 83 86 83 86 83 86 83 86 83 86 83 86 83 86 83 86 83 86 83 86 83 86 83 86 83 86 83 86 83 86 83 86 83 86 83 86 83 86 83 86 83 86 83 86 83 86
83 86 83 86 83 86 83 86 83 86 83 86 83 86 83 86 83 86 83 86 83 86 83 86 83 86 83 86 83 86 83 86 83 86 83 86 83 86 83 86 83 86 83 86 83 86 83 86 83 86
83 86 83 86 83 86 83 86 83 86 83 86 83 86 83 86 83 86 83 86 83 86 83 86 83 86 83 86 83 86 83 86 83 86 83 86 83 86 83 86 83 86 83 86 83 86 83 86 83 86
83 86 83 86 83 86 83 86 83 86 83 86 83 86 83 86 83 86 83 86 83 86 83 86 83 86 83 86 83 86 83 86 83 86 83 86 83 86 83 86 83 86 83 86 83 86 83 86 83 86
83 86 83 86 83 86 83 86 83 86 25 19 19 19 19 19 19 19 19 19 19 19 19 92 19 19 19 19 19 19 19 19 19 19 19 19 19 19 19 26 83 86 83 86 83 86 83 86 83 86
83 86 83 86 83 86 83 86 83 86 22 15 69 70 15 15 15 15 15 15 15 15 27 22 15 41 15 15 45 47 15 43 15 15 49 15 15 15 15 22 83 86 83 86 83 86 83 86 83 86
83 86 83 86 83 86 83 86 83 86 22 52 90 91 10 10 10 10 10 10 10 10 28 22 11 42 11 11 46 48 11 44 11 11 11 11 11 11 11 22 83 86 83 86 83 86 83 86 83 86
83 86 83 86 83 86 83 86 83 86 22 10 71 72 10 10 10 10 10 10 10 10 67 22 11 11 11 11 11 11 11 11 11 11 11 11 11 11 11 22 83 86 83 86 83 86 83 86 83 86
83 86 83 86 83 86 83 86 83 86 22 10 10 10 10 10 10 10 10 10 10 34 68 22 11 11 11 11 11 11 11 11 11 11 11 11 11 11 11 22 83 86 83 86 83 86 83 86 83 86
83 86 83 86 83 86 83 86 83 86 22 10 10 10 10 10 10 10 10 10 10 10 40 22 11 11 11 11 11 11 11 11 11 11 11 11 11 11 11 22 83 86 83 86 83 86 83 86 83 86
83 86 83 86 83 86 83 86 83 86 22 10 10 10 10 10 10 10 10 10 10 10 10 22 11 11 11 11 11 11 11 11 11 11 11 11 11 11 11 22 83 86 83 86 83 86 83 86 83 86
83 86 83 86 83 86 83 86 83 86 22 10 10 10 10 10 10 10 10 10 10 10 10 22 11 11 11 11 11 11 11 11 11 11 11 11 11 11 11 22 83 86 83 86 83 86 83 86 83 86
83 86 83 86 83 86 83 86 83 86 93 19 19 19 19 19 19 92 19 20 10 10 18 24 11 11 11 11 18 19 19 19 19 19 20 11 11 11 11 22 83 86 83 86 83 86 83 86 83 86
83 86 83 86 83 86 83 86 83 86 22 57 15 15 55 15 53 22 15 16 10 10 14 16 11 11 11 11 14 15 15 61 15 15 16 11 11 11 11 22 83 86 83 86 83 86 83 86 83 86
83 86 83 86 83 86 83 86 83 86 22 58 12 12 56 12 54 22 10 10 10 10 10 10 10 10 10 10 10 10 10 62 10 10 10 10 10 10 10 22 83 86 83 86 83 86 83 86 83 86
83 86 83 86 83 86 83 86 83 86 22 12 12 12 12 12 12 22 10 10 10 10 10 10 10 10 10 10 10 10 10 10 10 10 10 10 10 10 10 22 83 86 83 86 83 86 83 86 83 86
83 86 83 86 83 86 83 86 83 86 22 12 12 12 12 12 12 22 10 10 10 10 10 10 10 10 10 10 10 10 10 10 10 10 10 10 10 10 10 22 83 86 83 86 83 86 83 86 83 86
83 86 83 86 83 86 83 86 83 86 22 12 12 12 12 12 12 13 10 10 10 10 10 10 10 10 10 10 10 59 60 52 59 60 10 10 10 10 10 22 83 86 83 86 83 86 83 86 83 86
83 86 83 86 83 86 83 86 83 86 22 12 12 12 12 12 12 13 10 10 10 10 10 10 10 10 10 10 10 10 10 10 10 10 10 10 10 10 10 22 83 86 83 86 83 86 83 86 83 86
83 86 83 86 83 86 83 86 83 86 22 12 12 12 12 12 12 22 10 10 10 10 10 10 10 10 10 10 10 10 10 10 10 10 10 10 10 10 10 22 83 86 83 86 83 86 83 86 83 86
83 86 83 86 83 86 83 86 83 86 22 12 12 12 12 12 12 22 10 10 10 10 10 10 10 10 10 10 10 10 10 10 10 10 10 10 10 10 10 22 83 86 83 86 83 86 83 86 83 86
83 86 83 86 83 86 83 86 83 86 22 12 12 12 12 12 12 22 10 10 10 10 10 10 10 10 10 10 10 10 10 10 10 10 10 10 10 10 10 22 83 86 83 86 83 86 83 86 83 86
83 86 83 86 83 86 83 86 83 86 93 19 19 19 19 19 19 24 10 10 10 10 10 18 19 19 19 19 19 19 19 19 19 19 19 19 19 19 19 94 83 86 83 86 83 86 83 86 83 86
83 86 83 86 83 86 83 86 83 86 22 15 15 15 15 15 15 16 10 10 10 10 10 14 15 15 15 15 15 15 15 61 15 15 15 15 15 15 15 22 83 86 83 86 83 86 83 86 83 86
83 86 83 86 83 86 83 86 83 86 22 10 10 10 10 10 10 10 10 10 10 10 10 10 10 10 10 10 10 10 10 62 10 10 10 10 10 10 10 22 83 86 83 86 83 86 83 86 83 86
83 86 83 86 83 86 83 86 83 86 22 10 10 10 10 10 10 10 10 10 10 10 10 10 10 10 10 10 10 10 77 78 79 10 10 10 10 10 10 22 83 86 83 86 83 86 83 86 83 86
83 86 83 86 83 86 83 86 83 86 22 10 10 10 10 10 10 10 10 10 10 10 10 10 10 10 10 10 10 10 80 81 82 10 10 10 39 10 10 22 83 86 83 86 83 86 83 86 83 86
83 86 83 86 83 86 83 86 83 86 22 10 10 10 10 10 10 10 10 10 10 10 10 10 10 10 10 10 10 10 10 10 10 10 10 10 10 10 10 22 83 86 83 86 83 86 83 86 83 86
83 86 83 86 83 86 83 86 83 86 22 10 10 10 10 10 10 10 10 10 10 10 10 10 10 10 10 10 10 59 60 52 59 60 10 10 10 10 10 22 83 86 83 86 83 86 83 86 83 86
83 86 83 86 83 86 83 86 83 86 22 10 10 10 10 10 10 10 10 10 10 10 10 10 10 10 10 10 10 10 10 10 10 10 10 10 10 10 10 22 83 86 83 86 83 86 83 86 83 86
83 86 83 86 83 86 83 86 83 86 22 10 10 10 10 10 10 10 10 10 10 10 10 10 10 10 10 10 10 10 10 10 10 10 10 10 10 10 10 22 83 86 83 86 83 86 83 86 83 86
83 86 83 86 83 86 83 86 83 86 23 19 19 19 19 19 19 19 19 19 19 19 19 19 19 19 19 19 19 19 19 19 19 19 19 19 19 19 19 24 83 86 83 86 83 86 83 86 83 86
83 86 83 86 83 86 83 86 83 86 01 02 02 02 02 02 02 02 02 02 02 02 87 02 02 02 02 02 02 02 02 02 02 02 02 02 02 02 02 03 83 86 83 86 83 86 83 86 83 86
83 86 83 86 83 86 83 86 83 86 04 05 05 05 05 05 05 05 05 05 05 05 88 05 05 05 05 05 05 05 05 05 05 05 05 05 05 05 05 06 83 86 83 86 83 86 83 86 83 86
83 86 83 86 83 86 83 86 83 86 83 86 83 86 83 86 83 86 83 86 83 86 89 86 83 86 83 86 83 86 83 86 83 86 83 86 83 86 83 86 83 86 83 86 83 86 83 86 83 86
83 86 83 86 83 86 83 86 83 86 83 86 83 86 83 86 83 86 83 86 83 86 89 86 83 86 83 86 83 86 83 86 83 86 83 86 83 86 83 86 83 86 83 86 83 86 83 86 83 86
83 86 83 86 83 86 83 86 83 86 83 86 83 86 83 86 83 86 83 86 83 86 89 86 83 86 83 86 83 86 83 86 83 86 83 86 83 86 83 86 83 86 83 86 83 86 83 86 83 86
83 86 83 86 83 86 83 86 83 86 83 86 83 86 83 86 83 86 83 86 83 86 89 86 83 86 83 86 83 86 83 86 83 86 83 86 83 86 83 86 83 86 83 86 83 86 83 86 83 86
83 86 83 86 83 86 83 86 83 86 83 86 83 86 83 86 83 86 83 86 83 86 89 86 83 86 83 86 83 86 83 86 83 86 83 86 83 86 83 86 83 86 83 86 83 86 83 86 83 86
83 86 83 86 83 86 83 86 83 86 83 86 83 86 83 86 83 86 83 86 83 86 89 86 83 86 83 86 83 86 83 86 83 86 83 86 83 86 83 86 83 86 83 86 83 86 83 86 83 86
83 86 83 86 83 86 83 86 83 86 83 86 83 86 83 86 83 86 83 86 83 86 89 86 83 86 83 86 83 86 83 86 83 86 83 86 83 86 83 86 83 86 83 86 83 86 83 86 83 86
83 86 83 86 83 86 83 86 83 86 83 86 83 86 83 86 83 86 83 86 83 86 89 86 83 86 83 86 83 86 83 86 83 86 83 86 83 86 83 86 83 86 83 86 83 86 83 86 83 86
83 86 83 86 83 86 83 86 83 86 83 86 83 86 83 86 83 86 83 86 83 86 89 86 83 86 83 86 83 86 83 86 83 86 83 86 83 86 83 86 83 86 83 86 83 86 83 86 83 86
83 86 83 86 83 86 83 86 83 86 83 86 83 86 83 86 83 86 83 86 83 86 89 86 83 86 83 86 83 86 83 86 83 86 83 86 83 86 83 86 83 86 83 86 83 86 83 86 83 86