20 20
12 10
0 0 0 0 0 0 0 0 0 0 0 0 0 0 0 0 0 0 0 0
1 1 1 1 1 1 1 1 1 1 1 1 1 1 1 1 1 1 1 1
1 2 2 2 2 2 2 2 2 2 2 2 2 2 2 2 2 2 2 1
1 2 2 2 2 2 2 2 2 2 2 2 2 2 2 2 2 2 2 1
1 2 2 2 2 2 2 2 2 2 2 2 2 2 2 2 2 2 2 1
1 2 2 2 2 2 2 2 2 2 2 2 2 2 2 2 2 2 2 1
1 2 2 2 2 2 2 2 2 2 2 2 2 2 2 2 2 2 2 1
1 2 2 2 2 2 2 2 2 2 2 2 2 2 2 2 2 2 2 1
1 0 0 0 0 0 0 0 2 2 2 2 2 2 2 2 2 2 2 1
1 1 1 1 1 1 1 1 2 2 2 2 2 2 2 2 2 2 2 1
1 3 3 3 4 3 3 3 2 2 2 2 2 2 2 2 2 2 2 1
1 3 3 3 3 3 3 3 2 2 2 8 2 2 2 2 2 2 2 1
1 3 3 3 3 3 3 3 2 2 2 2 2 2 2 2 2 2 2 1
1 3 3 3 3 3 3 3 2 2 2 2 2 2 2 2 2 2 2 1
1 3 3 3 3 3 3 5 2 2 2 2 2 2 2 2 2 2 2 1
1 7 7 7 7 7 7 6 2 2 2 2 2 2 2 2 2 2 2 1
1 2 2 2 2 2 2 2 2 2 2 2 2 2 2 2 2 2 2 1
1 2 2 2 2 2 2 2 2 2 2 2 2 2 2 2 2 2 2 1
1 2 2 2 2 2 2 2 2 2 2 2 2 2 2 2 2 2 2 1
1 1 1 1 1 1 1 1 1 1 1 1 1 1 1 1 1 1 1 1