70 70
11 11
86 83 86 83 83 86 83 86 83 83 86 83 86 83 83 86 83 86 83 83 86 83 86 83 83 86 83 86 83 83 86 83 86 83 83 86 83 86 83 83 86 83 86 83 83 86 83 86 83 83 86 83 86 83 83 86 83 86 83 83 86 83 86 83 83 86 83 86 83 83
86 83 86 83 83 86 83 86 83 83 86 83 86 83 83 86 83 86 83 83 86 83 86 83 83 86 83 86 83 83 86 83 86 83 83 86 83 86 83 83 86 83 86 83 83 86 83 86 83 83 86 83 86 83 83 86 83 86 83 83 86 83 86 83 83 86 83 86 83 83
86 83 86 83 83 86 83 86 83 83 86 83 86 83 83 86 83 86 83 83 86 83 86 83 83 86 83 86 83 83 86 83 86 83 83 86 83 86 83 83 86 83 86 83 83 86 83 86 83 83 86 83 86 83 83 86 83 86 83 83 86 83 86 83 83 86 83 86 83 83
86 83 86 83 83 86 83 86 83 83 86 83 86 83 83 86 83 86 83 83 86 83 86 83 83 86 83 86 83 83 86 83 86 83 83 86 83 86 83 83 86 83 86 83 83 86 83 86 83 83 86 83 86 83 83 86 83 86 83 83 86 83 86 83 83 86 83 86 83 83
86 83 86 83 83 86 83 86 83 83 86 83 86 83 83 86 83 86 83 83 86 83 86 83 83 86 83 86 83 83 86 83 86 83 83 86 83 86 83 83 86 83 86 83 83 86 83 86 83 83 86 83 86 83 83 86 83 86 83 83 86 83 86 83 83 86 83 86 83 83
86 83 86 83 83 86 83 86 83 83 86 83 86 83 83 86 83 86 83 83 86 83 86 83 83 86 83 86 83 83 86 83 86 83 83 86 83 86 83 83 86 83 86 83 83 86 83 86 83 83 86 83 86 83 83 86 83 86 83 83 86 83 86 83 83 86 83 86 83 83
86 83 86 83 83 83 86 83 86 83 83 86 83 86 83 83 86 83 86 83 83 86 83 86 83 83 86 83 86 83 83 86 83 86 83 83 86 83 86 83 83 86 83 86 83 83 86 83 86 83 83 86 83 86 83 83 86 83 86 83 83 86 83 86 83 86 83 86 83 83
86 83 86 83 83 86 83 86 83 83 86 83 86 83 83 86 83 86 83 83 86 83 86 83 83 86 83 86 83 83 86 83 86 83 83 86 83 86 83 83 86 83 86 83 83 86 83 86 83 83 86 83 86 83 83 86 83 86 83 83 86 83 86 83 83 86 83 86 83 83
86 83 86 83 83 83 86 83 86 83 83 86 83 86 83 83 86 83 86 83 83 86 83 86 83 83 86 83 86 83 83 86 83 86 83 83 86 83 86 83 83 86 83 86 83 83 86 83 86 83 83 86 83 86 83 83 86 83 86 83 83 86 83 86 83 86 83 86 83 83
86 83 86 83 83 86 83 86 83 83 86 83 86 83 83 86 83 86 83 83 86 83 86 83 83 86 83 86 83 83 86 83 86 83 83 86 83 86 83 83 86 83 86 83 83 86 83 86 83 83 86 83 86 83 83 86 83 86 83 83 86 83 86 83 83 86 83 86 83 83
86 83 86 83 83 86 83 86 83 83 25 19 19 19 19 19 19 19 19 19 19 19 19 19 19 19 19 19 19 19 19 19 19 19 19 19 19 19 19 19 19 19 19 19 19 19 19 19 19 19 19 19 19 19 19 19 19 19 19 26 86 83 86 83 83 86 83 86 83 83
86 83 86 83 83 83 86 83 86 86 22 83 83 83 19 19 19 19 19 83 83 83 83 83 83 19 83 83 83 83 83 83 83 83 83 83 86 83 83 83 83 83 19 19 19 19 19 19 19 19 19 19 19 19 19 19 19 83 83 22 83 86 83 86 86 86 83 86 83 83
86 83 86 83 83 86 83 86 83 83 22 83 83 83 19 19 19 19 19 83 83 83 83 83 83 19 83 83 83 83 83 83 83 83 83 83 83 83 83 83 83 83 19 19 19 19 19 19 19 19 19 19 19 19 19 19 19 83 83 22 86 83 86 83 83 86 83 86 83 83
86 83 86 83 83 83 86 83 86 86 22 19 83 83 83 83 83 83 83 83 83 19 19 83 83 19 83 83 19 19 19 19 19 19 19 83 83 19 19 19 83 83 83 83 83 83 83 83 83 83 83 83 83 83 83 83 19 83 83 22 83 86 83 86 86 86 83 86 83 83
86 83 86 83 83 86 83 86 83 83 22 19 83 86 83 83 83 83 83 83 86 19 19 83 83 19 83 83 83 86 83 83 83 83 19 83 83 19 19 19 83 83 83 83 83 83 83 83 83 83 83 83 83 83 83 83 19 83 83 22 86 83 86 83 83 86 83 86 83 83
86 83 86 83 83 83 86 83 86 86 22 19 83 83 19 83 83 83 83 83 83 19 19 83 83 19 83 83 83 83 83 83 83 83 19 83 83 19 19 19 19 19 19 19 19 19 19 19 19 19 19 19 19 19 83 83 19 83 83 22 83 86 83 86 86 86 83 86 83 83
86 83 86 83 83 86 83 86 83 83 22 19 83 83 19 19 19 19 19 19 19 19 19 83 83 83 83 83 83 83 19 19 83 83 19 83 83 83 83 83 83 83 83 83 83 83 83 83 83 83 83 83 83 19 83 83 19 83 83 22 86 83 86 83 83 86 83 86 83 83
86 83 86 83 83 83 86 83 86 86 22 19 83 83 83 83 83 83 83 83 83 83 83 83 83 83 83 83 83 83 19 19 83 83 19 83 83 83 83 83 83 83 83 83 83 83 83 83 83 83 83 83 83 19 83 83 19 83 83 22 83 86 83 86 86 86 83 86 83 83
86 83 86 83 83 86 83 86 83 83 22 19 83 83 83 83 83 83 83 83 83 83 83 83 83 83 83 83 83 83 19 19 83 83 19 19 19 19 19 19 19 19 19 19 19 19 19 19 19 19 19 83 83 19 83 83 19 83 83 22 86 83 86 83 83 86 83 86 83 83
86 83 86 83 83 86 83 86 83 83 22 19 19 19 19 19 83 83 19 19 19 19 83 83 19 19 19 83 83 19 19 19 83 83 19 19 19 19 19 19 19 19 19 19 19 19 19 19 19 19 19 83 83 19 83 83 19 83 83 22 86 83 86 83 83 86 83 86 83 83
86 83 86 83 83 83 86 83 86 86 22 19 19 19 19 19 83 83 19 83 83 19 83 83 19 19 19 83 83 19 19 19 83 83 19 83 83 83 83 83 83 19 19 19 19 19 19 19 19 19 19 83 83 19 83 83 19 83 83 22 83 86 83 86 86 86 83 86 83 83
86 83 86 83 83 86 83 86 83 83 22 19 83 83 83 83 83 83 19 83 83 19 83 83 19 19 19 83 83 19 19 19 83 83 19 83 83 83 83 83 83 19 19 19 19 19 19 19 19 19 19 83 83 19 83 83 19 83 83 22 86 83 86 83 83 86 83 86 83 83
86 83 86 83 83 83 86 83 86 86 22 19 83 83 83 83 83 83 19 83 83 83 83 83 19 19 19 83 83 19 19 19 83 83 19 83 83 19 19 83 83 19 19 19 19 19 19 19 19 19 19 83 83 19 83 83 19 83 83 22 83 86 83 86 86 86 83 86 83 83
86 83 86 83 83 83 86 83 86 86 22 19 83 83 83 83 19 19 19 83 83 83 83 83 19 19 19 83 83 19 19 19 83 83 19 83 83 19 19 83 83 19 19 19 19 19 19 19 19 19 19 83 83 19 83 83 19 83 83 22 83 86 83 86 86 86 83 86 83 83
86 83 86 83 83 86 83 86 83 83 22 19 19 19 83 83 19 19 19 19 19 19 19 19 19 19 19 83 83 19 19 19 83 83 19 83 83 19 19 83 83 19 19 19 19 19 19 19 19 19 19 83 83 19 83 83 83 83 83 22 86 83 86 83 83 86 83 86 83 83
86 83 86 83 83 83 86 83 86 86 22 19 19 19 83 83 19 83 83 83 83 83 83 83 83 83 83 83 83 19 19 83 83 83 83 83 83 19 19 83 83 19 19 19 19 19 19 19 19 19 19 83 83 19 83 83 83 83 83 22 83 86 83 86 86 86 83 86 83 83
86 83 86 83 83 86 83 86 83 83 22 83 83 83 83 83 19 83 83 83 83 83 83 83 83 83 83 83 83 19 19 83 83 83 83 83 83 19 19 83 83 19 19 19 19 19 19 19 19 19 19 83 83 19 19 19 19 19 19 22 86 83 86 83 83 86 83 86 83 83
86 83 86 83 83 83 86 83 86 86 22 83 83 83 83 83 19 83 83 19 19 19 19 19 19 19 19 19 19 19 19 19 19 19 19 19 19 19 19 83 83 83 83 83 83 83 83 83 83 83 19 83 83 83 83 83 83 83 83 22 83 86 83 86 86 86 83 86 83 83
86 83 86 83 83 86 83 86 83 83 22 83 83 19 19 19 19 83 83 19 83 83 83 83 83 83 83 83 83 83 83 83 83 83 19 19 19 19 19 83 83 83 83 83 83 83 83 83 83 83 19 83 83 83 83 83 83 83 83 22 86 83 86 83 83 86 83 86 83 83
86 83 86 83 83 83 86 83 86 86 22 83 83 19 19 19 19 83 83 19 83 83 83 83 83 83 83 83 83 83 83 83 83 83 19 19 19 19 19 19 19 19 19 19 19 19 19 19 19 19 19 19 19 19 19 19 19 83 83 22 83 86 83 86 86 86 83 86 83 83
86 83 86 83 83 86 83 86 83 83 22 83 83 19 19 19 19 83 83 19 83 83 19 19 19 19 19 19 19 19 19 19 83 83 19 19 19 19 19 19 19 19 19 19 19 19 19 19 19 19 19 19 19 19 19 19 19 83 83 22 86 83 86 83 83 86 83 86 83 83
86 83 86 83 83 83 86 83 86 86 22 83 83 19 19 19 19 19 19 19 83 83 19 19 19 19 19 19 19 19 19 19 83 83 83 83 83 83 83 83 83 83 83 83 83 83 83 83 83 83 83 83 83 83 83 83 83 83 83 22 83 86 83 86 86 86 83 86 83 83
86 83 86 83 83 86 83 86 83 83 22 83 83 83 83 83 83 83 19 19 83 83 19 19 19 19 19 19 19 19 19 19 83 83 83 83 83 83 83 83 83 83 83 83 83 83 83 83 83 83 83 83 83 83 83 83 83 83 83 22 86 83 86 83 83 86 83 86 83 83
86 83 86 83 83 83 86 83 86 86 22 83 83 83 83 83 83 83 19 19 83 83 19 19 19 19 19 19 19 19 19 19 83 86 19 19 19 19 19 19 19 19 83 86 19 19 19 19 19 19 19 19 19 19 19 19 19 83 86 22 83 86 83 86 86 86 83 86 83 83
86 83 86 83 83 86 83 86 83 83 22 19 19 19 19 19 83 83 19 19 83 83 19 19 19 19 19 19 19 19 19 19 83 83 19 19 19 19 19 19 19 19 83 83 19 19 19 19 19 19 19 19 19 19 19 19 19 83 83 22 86 83 86 83 83 86 83 86 83 83
86 83 86 83 83 83 86 83 86 86 22 19 19 19 19 19 83 83 19 19 83 83 83 83 83 83 83 83 19 19 19 19 83 83 19 19 19 19 19 19 19 19 83 83 19 19 19 19 19 19 19 19 19 19 19 19 19 83 83 22 83 86 83 86 86 86 83 86 83 83
86 83 86 83 83 86 83 86 83 83 22 19 19 19 19 19 83 83 19 19 83 83 83 83 83 83 83 83 19 19 19 19 83 83 19 19 19 19 19 19 19 19 83 83 19 83 83 83 83 83 83 83 83 83 83 19 19 83 83 22 86 83 86 83 83 86 83 86 83 83
86 83 86 83 83 83 86 83 86 86 22 19 19 19 19 19 83 83 19 19 19 19 19 19 19 19 83 83 19 19 19 19 83 83 19 19 19 19 19 19 19 19 83 83 19 83 83 83 83 83 83 83 83 83 83 19 19 83 83 22 83 86 83 86 86 86 83 86 83 83
86 83 86 83 83 86 83 86 83 83 22 19 19 19 19 19 83 83 19 19 19 19 19 19 19 19 83 83 83 83 19 19 83 83 19 19 19 19 19 19 19 19 83 83 19 19 19 19 19 19 19 19 19 83 83 83 83 83 83 22 86 83 86 83 83 86 83 86 83 83
86 83 86 83 83 83 86 83 86 86 22 19 19 19 19 19 19 19 19 19 19 19 19 19 19 19 83 83 83 83 19 19 83 83 19 19 19 19 19 19 19 19 83 83 19 83 83 83 83 83 83 83 19 83 83 83 83 83 83 22 83 86 83 86 86 86 83 86 83 83
86 83 86 83 83 86 83 86 83 83 22 19 19 19 19 19 19 19 19 19 19 19 19 19 19 19 19 19 83 83 19 19 83 83 83 83 83 83 19 19 19 19 83 83 19 83 83 83 83 83 83 83 19 19 19 19 19 83 83 22 86 83 86 83 83 86 83 86 83 83
86 83 86 83 83 83 86 83 86 86 22 19 83 83 83 83 83 83 86 83 83 83 83 83 83 83 83 83 83 83 19 19 83 83 83 83 83 83 19 19 19 19 83 83 19 83 83 19 19 19 83 83 19 19 19 19 19 83 83 22 83 86 83 86 86 86 83 86 83 83
86 83 86 83 83 86 83 86 83 83 22 19 83 83 83 83 83 83 83 83 83 83 83 83 83 83 83 83 83 83 19 19 19 19 19 19 19 19 19 19 19 19 83 83 19 83 83 19 19 19 83 83 83 83 83 19 19 83 83 22 86 83 86 83 83 86 83 86 83 83
86 83 86 83 83 83 86 83 86 86 22 19 83 83 19 19 19 19 19 83 83 19 19 19 19 19 19 19 19 19 19 19 19 19 19 19 19 19 19 19 19 19 83 83 19 83 83 19 19 19 83 83 83 83 83 19 19 83 83 22 83 86 83 86 86 86 83 86 83 83
86 83 86 83 83 86 83 86 83 83 22 19 83 83 19 19 19 19 19 83 83 19 19 19 19 19 19 19 19 19 19 19 19 19 19 19 19 19 19 19 19 19 19 19 19 83 83 19 19 19 19 19 19 83 83 19 19 19 19 22 86 83 86 83 83 86 83 86 83 83
86 83 86 83 83 83 86 83 86 86 22 19 83 83 19 19 19 19 19 83 83 19 19 19 19 19 19 19 19 19 19 19 19 19 19 83 83 83 83 83 83 83 83 83 83 83 83 19 19 19 19 19 19 83 83 83 83 19 19 22 83 86 83 86 86 86 83 86 83 83
86 83 86 83 83 86 83 86 83 83 22 19 83 83 83 83 83 19 83 83 83 19 19 19 19 19 19 19 19 19 19 19 19 19 19 83 83 83 83 83 83 83 83 83 83 86 83 19 19 19 19 19 19 83 83 83 83 19 19 22 86 83 86 83 83 86 83 86 83 83
86 83 86 83 83 83 86 83 86 86 22 19 83 83 83 83 83 19 83 83 83 19 19 19 19 19 19 19 19 19 19 19 19 19 19 83 83 19 19 19 19 19 19 19 19 83 83 19 19 19 19 19 19 19 19 83 83 19 19 22 83 86 83 86 86 86 83 86 83 83
86 83 86 83 83 86 83 86 83 83 22 19 19 19 19 19 19 19 83 83 19 19 19 19 19 19 19 19 19 19 19 19 19 19 19 83 83 19 19 19 19 19 83 83 19 83 83 19 19 19 19 83 83 83 83 83 83 19 19 22 86 83 86 83 83 86 83 86 83 83
86 83 86 83 83 83 86 83 86 86 22 19 19 19 83 83 83 86 83 83 83 83 83 83 83 83 83 83 83 83 83 83 83 83 83 83 83 19 19 19 19 19 83 83 19 83 83 19 19 19 19 83 83 83 83 83 83 83 83 22 83 86 83 86 86 86 83 86 83 83
86 83 86 83 83 86 83 86 83 83 22 19 19 19 83 83 83 83 83 83 83 83 83 83 83 83 83 83 83 83 83 83 83 83 83 86 83 19 19 19 19 19 83 83 19 83 83 19 19 19 19 83 83 19 19 83 83 83 83 22 86 83 86 83 83 86 83 86 83 83
86 83 86 83 83 83 86 83 86 86 22 19 19 19 83 83 19 19 19 19 19 19 19 19 19 19 19 19 19 19 19 19 19 19 19 83 83 19 19 19 19 19 83 83 19 83 83 19 19 19 19 83 83 83 83 83 83 83 83 22 83 86 83 86 86 86 83 86 83 83
86 83 86 83 83 86 83 86 83 83 22 19 19 19 83 83 19 19 19 19 19 19 19 19 19 19 19 19 19 19 19 19 19 19 19 83 83 19 19 19 19 19 83 83 19 83 83 19 19 19 19 83 83 83 83 83 83 83 83 22 86 83 86 83 83 86 83 86 83 83
86 83 86 83 83 83 86 83 86 86 22 19 19 19 83 83 19 19 19 19 19 83 83 83 83 83 83 83 83 83 83 83 83 83 83 83 83 83 83 83 83 83 83 83 19 83 83 19 19 19 19 19 19 19 19 19 19 83 83 22 83 86 83 86 86 86 83 86 83 83
86 83 86 83 83 86 83 86 83 83 22 19 19 19 83 83 19 19 19 19 19 83 83 83 83 83 83 83 83 83 83 83 83 83 83 83 83 83 83 83 83 83 83 83 19 83 83 83 83 83 83 83 83 83 83 83 19 83 83 22 86 83 86 83 83 86 83 86 83 83
86 83 86 83 83 83 86 83 86 86 22 19 19 19 83 83 19 19 19 19 19 19 19 19 19 19 19 19 83 83 19 19 19 19 19 19 19 19 19 19 19 19 19 19 19 83 83 83 83 83 83 83 83 83 83 83 19 83 83 22 83 86 83 86 86 86 83 86 83 83
86 83 86 83 83 86 83 86 83 83 22 19 19 19 83 83 19 19 19 19 19 19 19 19 19 19 19 19 83 83 19 19 19 19 19 19 19 19 19 19 19 19 19 19 19 19 19 19 19 19 19 19 19 19 19 19 19 83 83 22 83 86 83 86 86 86 83 86 83 83
86 83 86 83 83 83 86 83 86 86 22 19 19 19 19 19 19 19 19 19 19 19 19 19 19 19 19 19 83 83 83 83 83 83 83 83 83 83 83 83 83 83 83 83 83 83 83 83 83 83 83 83 83 83 83 83 19 83 83 22 86 83 86 83 83 86 83 86 83 83
86 83 86 83 83 83 86 83 86 86 22 19 19 19 19 19 19 19 19 19 19 19 19 19 19 19 19 19 83 83 83 83 83 83 83 83 83 83 83 83 83 83 83 83 83 83 83 83 83 83 83 83 83 83 83 83 19 83 95 22 86 83 86 83 83 86 83 86 83 83
86 83 86 83 83 86 83 86 83 83 23 19 19 19 19 19 19 19 19 19 19 19 19 19 19 19 19 19 19 19 19 19 19 19 19 19 19 19 19 19 19 19 19 19 19 19 19 19 19 19 19 19 19 19 19 19 19 19 19 24 86 83 86 83 83 86 83 86 83 83
86 83 86 83 83 86 83 86 83 83 86 83 86 83 83 86 83 86 83 83 86 83 86 83 83 86 83 86 83 83 86 83 86 83 83 86 83 86 83 83 86 83 86 83 83 86 83 86 83 83 86 83 86 83 83 86 83 86 83 83 86 83 86 83 83 86 83 86 83 83
86 83 86 83 83 83 86 83 86 83 83 86 83 86 83 83 86 83 86 83 83 86 83 86 83 83 86 83 86 83 83 86 83 86 83 83 86 83 86 83 83 86 83 86 83 83 86 83 86 83 83 86 83 86 83 83 86 83 86 83 83 86 83 86 83 86 83 86 83 83
86 83 86 83 83 86 83 86 83 83 86 83 86 83 83 86 83 86 83 83 86 83 86 83 83 86 83 86 83 83 86 83 86 83 83 86 83 86 83 83 86 83 86 83 83 86 83 86 83 83 86 83 86 83 83 86 83 86 83 83 86 83 86 83 83 86 83 86 83 83
86 83 86 83 83 83 86 83 86 83 83 86 83 86 83 83 86 83 86 83 83 86 83 86 83 83 86 83 86 83 83 86 83 86 83 83 86 83 86 83 83 86 83 86 83 83 86 83 86 83 83 86 83 86 83 83 86 83 86 83 83 86 83 86 83 86 83 86 83 83
86 83 86 83 83 86 83 86 83 83 86 83 86 83 83 86 83 86 83 83 86 83 86 83 83 86 83 86 83 83 86 83 86 83 83 86 83 86 83 83 86 83 86 83 83 86 83 86 83 83 86 83 86 83 83 86 83 86 83 83 86 83 86 83 83 86 83 86 83 83
86 83 86 83 83 86 83 86 83 83 86 83 86 83 83 86 83 86 83 83 86 83 86 83 83 86 83 86 83 83 86 83 86 83 83 86 83 86 83 83 86 83 86 83 83 86 83 86 83 83 86 83 86 83 83 86 83 86 83 83 86 83 86 83 83 86 83 86 83 83
86 83 86 83 83 86 83 86 83 83 86 83 86 83 83 86 83 86 83 83 86 83 86 83 83 86 83 86 83 83 86 83 86 83 83 86 83 86 83 83 86 83 86 83 83 86 83 86 83 83 86 83 86 83 83 86 83 86 83 83 86 83 86 83 83 86 83 86 83 83
86 83 86 83 83 86 83 86 83 83 86 83 86 83 83 86 83 86 83 83 86 83 86 83 83 86 83 86 83 83 86 83 86 83 83 86 83 86 83 83 86 83 86 83 83 86 83 86 83 83 86 83 86 83 83 86 83 86 83 83 86 83 86 83 83 86 83 86 83 83
86 83 86 83 83 86 83 86 83 83 86 83 86 83 83 86 83 86 83 83 86 83 86 83 83 86 83 86 83 83 86 83 86 83 83 86 83 86 83 83 86 83 86 83 83 86 83 86 83 83 86 83 86 83 83 86 83 86 83 83 86 83 86 83 83 86 83 86 83 83
86 83 86 83 83 86 83 86 83 83 86 83 86 83 83 86 83 86 83 83 86 83 86 83 83 86 83 86 83 83 86 83 86 83 83 86 83 86 83 83 86 83 86 83 83 86 83 86 83 83 86 83 86 83 83 86 83 86 83 83 86 83 86 83 83 86 83 86 83 83

