60 60
06 05
86 83 86 83 83 86 83 86 83 83 86 83 86 83 83 86 83 86 83 83 86 83 86 83 83 86 83 86 83 83 86 83 86 83 83 86 83 86 83 83 86 83 86 83 83 86 83 86 83 83 86 83 86 83 83 86 83 86 83 83
83 86 83 86 83 83 86 83 86 83 83 86 83 86 83 83 86 83 86 83 83 86 83 86 83 83 86 83 86 83 83 86 83 86 83 83 86 83 86 83 83 86 83 86 83 83 86 83 86 83 83 86 83 86 83 83 86 83 86 83
86 83 86 83 83 86 83 86 83 83 86 83 86 83 83 86 83 86 83 83 86 83 86 83 83 86 83 86 83 83 86 83 86 83 83 86 83 86 83 83 86 83 86 83 83 86 83 86 83 83 86 83 86 83 83 86 83 86 83 83
83 86 83 86 83 83 86 83 86 83 83 86 83 86 83 83 86 83 86 83 83 86 83 86 83 83 86 83 86 83 83 86 83 86 83 83 86 83 86 83 83 86 83 86 83 83 86 83 86 83 83 86 83 86 83 83 86 83 86 83
86 83 86 83 83 86 83 86 83 83 86 83 86 83 83 86 83 86 83 83 86 83 86 83 83 86 83 86 83 83 86 83 86 83 83 86 83 86 83 83 86 83 86 83 83 86 83 86 83 83 86 83 86 83 83 86 83 86 83 83
86 83 86 83 83 25 19 19 19 19 19 19 19 19 19 19 19 19 19 19 19 19 19 19 19 19 19 19 19 19 19 19 19 19 19 19 19 19 19 19 19 19 19 19 19 19 19 19 19 19 19 19 19 19 26 86 83 86 83 83
83 86 83 86 86 22 83 83 83 00 00 00 00 00 00 83 83 83 83 83 00 83 83 83 83 83 83 83 83 83 83 86 83 83 83 83 83 00 00 00 00 00 00 00 00 00 00 00 00 00 00 00 00 83 22 83 86 83 86 86
86 83 86 83 83 22 00 00 83 00 00 00 00 00 00 83 00 00 00 83 00 83 00 00 00 00 00 00 00 00 83 00 00 00 00 00 83 00 00 00 00 00 00 00 00 00 00 00 00 00 00 00 00 83 22 86 83 86 83 83
83 86 83 86 86 22 00 00 83 83 83 83 83 83 83 83 00 00 00 83 00 83 00 00 00 00 00 00 00 00 83 00 00 00 00 00 83 83 83 83 83 83 83 83 83 83 83 83 83 83 83 00 00 83 22 83 86 83 86 86
86 83 86 83 83 22 00 00 86 00 00 00 00 00 00 86 00 00 00 83 00 83 83 83 86 83 83 83 83 00 83 00 00 00 00 00 00 00 00 00 00 00 00 00 00 00 00 00 00 00 83 00 00 83 22 86 83 86 83 83
83 86 83 86 86 22 00 00 83 00 83 83 83 83 83 83 00 00 00 83 00 00 00 83 00 00 00 00 83 00 83 00 00 00 00 00 00 00 00 00 00 00 00 00 00 00 00 00 00 00 83 00 00 83 22 83 86 83 86 86
86 83 86 83 83 22 00 00 83 00 00 00 00 00 00 00 00 00 00 83 83 83 83 83 00 00 00 00 83 00 83 00 00 00 00 00 00 00 00 00 00 00 00 00 00 00 00 00 00 00 83 00 00 83 22 86 83 86 83 83
83 86 83 86 86 22 00 00 83 00 00 00 00 00 00 00 00 00 00 00 00 00 00 00 00 00 00 00 83 00 83 83 83 83 83 83 83 83 83 83 83 83 83 83 83 83 83 83 00 00 83 00 00 83 22 83 86 83 86 86
86 83 86 83 83 22 00 00 83 83 83 83 83 83 83 83 83 83 83 83 83 83 83 83 00 00 00 00 83 00 00 00 00 00 00 00 00 00 00 00 00 00 00 00 00 00 00 83 00 00 83 00 00 83 22 86 83 86 83 83
86 83 86 83 83 22 00 00 00 00 00 00 83 00 00 00 00 83 00 00 00 00 00 83 00 00 00 00 83 00 00 00 00 00 00 00 00 00 00 00 00 00 00 00 00 00 00 83 00 00 83 00 00 83 22 86 83 86 83 83
83 86 83 86 86 22 00 00 00 00 00 00 83 00 83 00 00 83 00 00 00 00 00 83 00 00 00 00 83 00 00 00 00 00 00 00 00 00 00 00 00 00 00 00 00 00 00 83 00 00 83 00 00 83 22 83 86 83 86 86
86 83 86 83 83 22 00 83 83 83 83 83 83 00 83 00 00 83 00 00 00 00 00 83 00 00 00 00 83 00 00 83 83 83 83 00 00 00 00 00 00 00 00 00 00 00 00 83 00 00 83 00 00 83 22 86 83 86 83 83
83 86 83 86 86 22 00 83 00 00 83 00 00 00 83 00 00 83 00 00 00 00 00 83 00 00 00 00 83 00 00 83 00 00 83 00 00 00 00 00 00 00 00 00 00 00 00 83 00 00 83 00 00 83 22 83 86 83 86 86
83 86 83 86 86 22 00 83 00 00 83 00 00 00 83 00 00 83 00 00 00 00 00 83 00 00 00 00 83 00 00 83 00 00 83 00 00 00 00 00 00 00 00 00 00 00 00 83 00 00 83 00 00 83 22 83 86 83 86 86
86 83 86 83 83 22 00 00 00 00 83 00 83 83 83 83 83 83 00 00 00 00 00 83 00 00 00 00 83 00 00 83 00 00 83 00 00 00 00 00 00 00 00 00 00 00 00 83 00 00 83 00 00 83 22 86 83 86 83 83
83 86 83 86 86 22 00 00 00 00 83 00 00 00 00 00 00 00 00 00 00 00 00 83 00 00 00 00 83 00 00 83 00 00 83 00 00 00 00 00 00 00 00 00 00 00 00 83 00 00 83 83 83 83 22 83 86 83 86 86
86 83 86 83 83 22 00 00 00 00 83 00 83 83 83 83 83 83 83 83 83 83 83 83 00 00 83 83 83 83 83 83 00 00 83 00 00 00 00 00 00 00 00 00 00 00 00 83 00 00 00 00 00 00 22 86 83 86 83 83
83 86 83 86 86 22 83 83 83 83 83 00 83 00 00 00 00 00 00 00 00 00 00 00 00 00 00 00 00 00 00 00 00 00 83 00 00 00 00 00 00 00 00 00 00 00 00 83 83 83 83 83 83 83 22 83 86 83 86 86
86 83 86 83 83 22 83 00 00 00 00 00 83 00 00 83 83 83 83 83 83 83 83 83 83 83 83 83 83 00 00 00 00 00 83 83 83 83 83 83 83 83 83 83 83 83 00 00 00 00 00 00 00 83 22 86 83 86 83 83
83 86 83 86 86 22 83 00 00 00 00 00 83 00 00 83 00 00 00 00 00 00 00 00 00 00 00 00 83 00 00 00 00 00 00 00 00 00 00 00 00 00 00 00 00 00 00 00 00 00 00 00 00 83 22 83 86 83 86 86
86 83 86 83 83 22 83 00 00 00 00 00 83 00 00 83 00 00 00 00 00 00 00 00 00 00 00 00 83 00 00 00 00 00 00 00 00 00 00 00 00 00 00 00 00 00 00 00 00 00 00 00 00 83 22 86 83 86 83 83
83 86 83 86 86 22 83 00 00 00 00 00 00 00 00 83 00 00 00 00 00 00 00 00 00 00 00 00 83 00 00 00 00 00 00 00 00 00 00 00 00 00 00 00 00 00 00 00 00 00 00 00 00 83 22 83 86 83 86 86
86 83 86 83 83 22 83 00 00 00 00 00 00 00 00 83 00 00 00 00 00 00 00 00 00 00 00 00 83 83 83 83 83 83 83 83 83 83 83 83 83 83 83 83 83 83 83 83 83 83 83 83 83 83 22 86 83 86 83 83
83 86 83 86 86 22 83 83 83 83 83 83 00 00 00 83 00 00 00 00 00 00 00 00 00 00 00 00 00 00 00 00 00 00 00 00 00 00 00 00 00 00 00 00 00 00 00 00 00 00 00 00 00 00 22 83 86 83 86 86
86 83 86 83 83 22 00 00 00 00 00 83 00 00 00 83 00 00 00 00 00 00 00 00 00 00 00 00 00 00 00 00 00 00 00 00 00 00 00 00 00 00 00 00 00 00 00 00 00 00 00 00 00 00 22 86 83 86 83 83
83 86 83 86 86 22 00 00 00 00 00 83 00 00 00 83 00 00 00 00 00 00 00 00 00 00 00 00 00 00 00 00 00 00 00 00 00 00 00 00 00 00 00 00 00 00 00 00 00 00 00 00 00 00 22 83 86 83 86 86
86 83 86 83 83 22 00 00 00 00 00 83 00 00 00 83 83 83 83 83 83 83 83 00 00 00 00 00 00 00 00 00 00 00 00 00 00 00 00 00 00 00 00 00 00 00 00 00 00 00 00 00 00 00 22 86 83 86 83 83
83 86 83 86 86 22 00 00 00 00 00 00 00 00 00 00 00 00 00 00 00 00 83 00 00 00 00 00 00 00 00 00 00 00 00 00 00 00 00 00 00 00 00 00 00 00 00 00 00 00 00 00 00 00 22 83 86 83 86 86
86 83 86 83 83 22 00 00 00 00 00 00 00 00 00 00 00 00 00 00 00 00 83 00 00 00 00 00 00 00 00 00 00 00 00 00 00 00 00 00 00 00 00 00 00 00 00 00 00 00 00 00 00 00 22 86 83 86 83 83
83 86 83 86 86 22 00 00 00 00 00 00 00 00 00 00 00 00 00 00 00 00 83 83 83 00 00 00 00 00 00 00 00 00 00 00 00 00 00 00 83 83 83 83 83 83 83 00 00 00 00 00 00 00 22 83 86 83 86 86
86 83 86 83 83 22 00 00 00 00 00 00 00 00 00 00 00 00 00 00 00 00 00 00 83 00 00 00 00 00 00 00 00 00 00 00 00 00 00 00 83 00 00 00 00 00 83 00 00 00 00 00 00 00 22 86 83 86 83 83
83 86 83 86 86 22 00 00 00 00 00 00 00 00 83 83 83 83 83 83 83 83 83 83 83 00 00 00 00 00 00 00 00 00 00 00 00 00 00 00 83 00 00 00 00 00 83 00 00 00 00 00 00 00 22 83 86 83 86 86
86 83 86 83 83 22 00 00 00 00 00 00 00 00 83 00 00 00 00 00 00 00 00 00 00 00 00 00 00 00 00 00 00 00 00 00 00 00 00 00 83 00 00 00 00 00 83 83 83 83 00 00 00 00 22 86 83 86 83 83
83 86 83 86 86 22 00 00 00 00 00 00 00 00 83 00 00 00 00 00 00 00 00 00 00 00 00 00 00 00 00 00 00 00 00 00 00 00 00 00 83 00 00 00 00 00 00 00 00 83 00 00 00 00 22 83 86 83 86 86
86 83 86 83 83 22 00 00 00 00 00 00 00 00 83 83 00 00 00 00 00 00 00 00 00 00 00 00 00 00 00 00 00 00 00 00 00 00 00 00 83 00 00 00 00 00 00 00 00 83 00 00 00 00 22 86 83 86 83 83
83 86 83 86 86 22 00 00 00 00 00 00 00 00 00 83 00 00 00 00 00 00 00 00 00 00 00 00 00 00 83 83 83 83 83 83 83 83 83 83 83 00 00 00 00 00 00 00 00 83 83 83 00 00 22 83 86 83 86 86
86 83 86 83 83 22 00 00 00 00 00 00 00 00 00 83 00 00 00 00 00 00 00 00 00 00 00 00 00 00 83 00 00 00 00 00 00 00 00 00 00 00 00 00 00 00 00 00 00 00 00 83 00 00 22 86 83 86 83 83
83 86 83 86 86 22 00 00 00 00 00 00 00 83 83 83 00 00 00 00 00 00 00 00 00 00 00 00 00 00 83 00 00 00 00 00 00 00 00 00 00 00 00 00 00 00 00 00 00 00 00 83 00 00 22 83 86 83 86 86
86 83 86 83 83 22 00 00 00 00 00 00 00 83 00 00 00 00 00 00 00 00 00 00 00 00 00 00 00 00 83 00 00 00 00 00 00 00 00 00 00 00 00 00 00 00 00 83 83 83 83 83 00 00 22 86 83 86 83 83
83 86 83 86 86 22 00 00 00 00 00 00 00 83 83 83 83 83 83 83 83 83 83 83 83 83 83 83 83 83 83 00 00 00 00 00 00 00 00 00 00 00 00 00 00 00 00 83 00 00 00 00 00 00 22 83 86 83 86 86
86 83 86 83 83 22 00 00 00 00 00 00 00 00 00 00 00 00 00 00 00 00 00 00 00 00 00 00 00 00 00 00 00 00 00 00 00 00 00 00 00 00 00 00 00 00 00 83 00 00 83 83 83 83 22 86 83 86 83 83
83 86 83 86 86 22 00 00 00 00 00 00 00 00 00 00 00 00 00 00 00 00 00 00 00 00 00 00 00 00 00 00 00 00 00 00 00 00 00 00 00 00 00 00 00 00 00 83 00 00 83 00 00 83 22 83 86 83 86 86
86 83 86 83 83 22 00 00 00 00 00 00 00 00 00 00 00 00 00 00 00 00 00 00 00 00 00 00 00 00 00 00 00 00 00 00 00 00 00 00 00 00 00 00 00 00 00 83 83 83 83 00 00 83 22 86 83 86 83 83
83 86 83 86 86 22 00 00 00 00 00 00 00 00 00 00 00 00 00 00 00 00 00 00 00 00 00 00 00 00 00 00 00 00 00 00 00 00 00 00 00 00 00 00 00 00 00 00 00 00 00 00 00 83 22 83 86 83 86 86
86 83 86 83 83 22 00 00 00 00 00 00 00 00 00 00 00 00 00 00 00 00 00 00 00 00 00 00 00 00 00 00 00 00 00 00 00 00 00 00 00 00 00 00 00 00 00 00 00 00 00 00 00 83 22 86 83 86 83 83
83 86 83 86 86 22 00 00 00 00 00 00 00 00 00 00 00 00 00 00 00 00 00 00 00 00 00 00 00 00 00 00 00 00 00 00 00 00 00 00 00 00 00 00 00 00 00 00 00 00 00 00 00 83 22 83 86 83 86 86
86 83 86 83 83 22 00 00 00 00 00 00 00 00 00 00 00 00 00 00 00 00 00 00 00 00 00 00 00 00 00 00 00 00 00 00 00 00 00 00 00 00 00 00 00 00 00 00 00 00 00 00 00 83 22 83 86 83 86 86
83 86 83 86 86 22 00 00 00 00 00 00 00 00 00 00 00 00 00 00 00 00 00 00 00 00 00 00 00 00 00 00 00 00 00 00 00 00 00 00 00 00 00 00 00 00 00 00 00 00 00 00 00 83 22 86 83 86 83 83
83 86 83 86 86 22 00 00 00 00 00 00 00 00 00 00 00 00 00 00 00 00 00 00 00 00 00 00 00 00 00 00 00 00 00 00 00 00 00 00 00 00 00 00 00 00 00 00 00 00 00 00 00 95 22 86 83 86 83 83
86 83 86 83 83 23 19 19 19 19 19 19 19 19 19 19 19 19 19 19 19 19 19 19 19 19 19 19 19 19 19 19 19 19 19 19 19 19 19 19 19 19 19 19 19 19 19 19 19 19 19 19 19 19 24 86 83 86 83 83
86 83 86 83 83 86 83 86 83 83 86 83 86 83 83 86 83 86 83 83 86 83 86 83 83 86 83 86 83 83 86 83 86 83 83 86 83 86 83 83 86 83 86 83 83 86 83 86 83 83 86 83 86 83 83 86 83 86 83 83
83 86 83 86 83 83 86 83 86 83 83 86 83 86 83 83 86 83 86 83 83 86 83 86 83 83 86 83 86 83 83 86 83 86 83 83 86 83 86 83 83 86 83 86 83 83 86 83 86 83 83 86 83 86 83 83 86 83 86 83
86 83 86 83 83 86 83 86 83 83 86 83 86 83 83 86 83 86 83 83 86 83 86 83 83 86 83 86 83 83 86 83 86 83 83 86 83 86 83 83 86 83 86 83 83 86 83 86 83 83 86 83 86 83 83 86 83 86 83 83
83 86 83 86 83 83 86 83 86 83 83 86 83 86 83 83 86 83 86 83 83 86 83 86 83 83 86 83 86 83 83 86 83 86 83 83 86 83 86 83 83 86 83 86 83 83 86 83 86 83 83 86 83 86 83 83 86 83 86 83
86 83 86 83 83 86 83 86 83 83 86 83 86 83 83 86 83 86 83 83 86 83 86 83 83 86 83 86 83 83 86 83 86 83 83 86 83 86 83 83 86 83 86 83 83 86 83 86 83 83 86 83 86 83 83 86 83 86 83 83
