40 40
10 10
86 83 86 83 83 86 83 86 83 83 86 83 86 83 83 86 83 86 83 83 86 83 86 83 83 86 83 86 83 83 86 83 86 83 83 86 83 86 83 83 
86 83 86 83 83 86 83 86 83 83 86 83 86 83 83 86 83 86 83 83 86 83 86 83 83 86 83 86 83 83 86 83 86 83 83 86 83 86 83 83 
86 83 86 83 83 86 83 86 83 83 86 83 86 83 83 86 83 86 83 83 86 83 86 83 83 86 83 86 83 83 86 83 86 83 83 86 83 86 83 83 
86 83 86 83 83 86 83 86 83 83 86 83 86 83 83 86 83 86 83 83 86 83 86 83 83 86 83 86 83 83 86 83 86 83 83 86 83 86 83 83 
86 83 86 83 83 86 83 86 83 83 86 83 86 83 83 86 83 86 83 83 86 83 86 83 83 86 83 86 83 83 86 83 86 83 83 86 83 86 83 83 
86 83 86 83 83 25 19 19 19 19 19 19 19 19 19 19 19 19 19 19 19 19 19 19 19 19 19 19 19 19 19 19 19 19 26 86 83 86 83 83 
86 83 86 83 83 22 86 83 86 83 83 86 83 86 83 83 86 83 86 83 83 86 83 86 83 83 86 83 86 83 83 86 83 86 22 86 83 86 83 83
86 83 86 83 83 22 86 83 86 83 83 86 83 86 83 83 86 83 86 83 83 86 83 86 83 83 86 83 86 83 83 86 83 86 22 86 83 86 83 83
86 83 86 83 83 22 86 83 86 83 83 86 83 86 83 83 86 83 86 83 83 86 83 86 83 83 86 83 86 83 83 86 83 86 22 86 83 86 83 83
86 83 86 83 83 22 86 83 86 83 83 86 83 86 83 83 86 83 86 83 83 86 83 86 83 83 86 83 86 83 83 86 83 86 22 86 83 86 83 83
86 83 86 83 83 22 86 83 86 83 83 86 83 86 83 83 86 83 86 83 83 86 83 86 83 83 86 83 86 83 83 86 83 86 22 86 83 86 83 83
86 83 86 83 83 22 86 83 86 83 83 86 83 86 83 83 86 83 86 83 83 86 83 86 83 83 86 83 86 83 83 86 83 86 22 86 83 86 83 83
86 83 86 83 83 22 86 83 86 83 83 86 83 86 83 83 86 83 86 83 83 86 83 86 83 83 86 83 86 83 83 86 83 86 22 86 83 86 83 83
86 83 86 83 83 22 86 83 86 83 83 86 83 86 83 83 86 83 86 83 83 86 83 86 83 83 86 83 86 83 83 86 83 86 22 86 83 86 83 83
86 83 86 83 83 22 86 83 86 83 83 86 83 86 83 83 86 83 86 83 83 86 83 86 83 83 86 83 86 83 83 86 83 86 22 86 83 86 83 83
86 83 86 83 83 22 86 83 86 83 83 86 83 86 83 83 86 83 86 83 83 86 83 86 83 83 86 83 86 83 83 86 83 86 22 86 83 86 83 83
86 83 86 83 83 22 86 83 86 83 83 86 83 86 83 83 86 83 86 83 83 86 83 86 83 83 86 83 86 83 83 86 83 86 22 86 83 86 83 83
86 83 86 83 83 22 86 83 86 83 83 86 83 86 83 83 86 83 86 83 83 86 83 86 83 83 86 83 86 83 83 86 83 86 22 86 83 86 83 83
86 83 86 83 83 22 86 83 86 83 83 86 83 86 83 83 86 83 86 83 83 86 83 86 83 83 86 83 86 83 83 86 83 86 22 86 83 86 83 83
86 83 86 83 83 22 86 83 86 83 83 86 83 86 83 83 86 83 86 83 83 86 83 86 83 83 86 83 86 83 83 86 83 86 22 86 83 86 83 83
86 83 86 83 83 22 86 83 86 83 83 86 83 86 83 83 86 83 86 83 83 86 83 86 83 83 86 83 86 83 83 86 83 86 22 86 83 86 83 83
86 83 86 83 83 22 86 83 86 83 83 86 83 86 83 83 86 83 86 83 83 86 83 86 83 83 86 83 86 83 83 86 83 86 22 86 83 86 83 83
86 83 86 83 83 22 86 83 86 83 83 86 83 86 83 83 86 83 86 83 83 86 83 86 83 83 86 83 86 83 83 86 83 86 22 86 83 86 83 83
86 83 86 83 83 22 86 83 86 83 83 86 83 86 83 83 86 83 86 83 83 86 83 86 83 83 86 83 86 83 83 86 83 86 22 86 83 86 83 83
86 83 86 83 83 22 86 83 86 83 83 86 83 86 83 83 86 83 86 83 83 86 83 86 83 83 86 83 86 83 83 86 83 86 22 86 83 86 83 83
86 83 86 83 83 22 86 83 86 83 83 86 83 86 83 83 86 83 86 83 83 86 83 86 83 83 86 83 86 83 83 86 83 86 22 86 83 86 83 83
86 83 86 83 83 22 86 83 86 83 83 86 83 86 83 83 86 83 86 83 83 86 83 86 83 83 86 83 86 83 83 86 83 86 22 86 83 86 83 83
86 83 86 83 83 22 86 83 86 83 83 86 83 86 83 83 86 83 86 83 83 86 83 86 83 83 86 83 86 83 83 86 83 86 22 86 83 86 83 83
86 83 86 83 83 22 86 83 86 83 83 86 83 86 83 83 86 83 86 83 83 86 83 86 83 83 86 83 86 83 83 86 83 86 22 86 83 86 83 83
86 83 86 83 83 22 86 83 86 83 83 86 83 86 83 83 86 83 86 83 83 86 83 86 83 83 86 83 86 83 83 86 83 86 22 86 83 86 83 83
86 83 86 83 83 22 86 83 86 83 83 86 83 86 83 83 86 83 86 83 83 86 83 86 83 83 86 83 86 83 83 86 83 86 22 86 83 86 83 83
86 83 86 83 83 22 86 83 86 83 83 86 83 86 83 83 86 83 86 83 83 86 83 86 83 83 86 83 86 83 83 86 83 86 22 86 83 86 83 83
86 83 86 83 83 23 19 19 19 19 19 19 19 19 19 19 19 19 19 19 19 19 19 19 19 19 19 19 19 19 19 19 19 19 24 86 83 86 83 83
86 83 86 83 83 86 83 86 83 83 86 83 86 83 83 86 83 86 83 83 86 83 86 83 83 86 83 86 83 83 86 83 86 83 83 86 83 86 83 83
86 83 86 83 83 86 83 86 83 83 86 83 86 83 83 86 83 86 83 83 86 83 86 83 83 86 83 86 83 83 86 83 86 83 83 86 83 86 83 83
86 83 86 83 83 86 83 86 83 83 86 83 86 83 83 86 83 86 83 83 86 83 86 83 83 86 83 86 83 83 86 83 86 83 83 86 83 86 83 83
86 83 86 83 83 86 83 86 83 83 86 83 86 83 83 86 83 86 83 83 86 83 86 83 83 86 83 86 83 83 86 83 86 83 83 86 83 86 83 83
86 83 86 83 83 86 83 86 83 83 86 83 86 83 83 86 83 86 83 83 86 83 86 83 83 86 83 86 83 83 86 83 86 83 83 86 83 86 83 83
86 83 86 83 83 86 83 86 83 83 86 83 86 83 83 86 83 86 83 83 86 83 86 83 83 86 83 86 83 83 86 83 86 83 83 86 83 86 83 83
86 83 86 83 83 86 83 86 83 83 86 83 86 83 83 86 83 86 83 83 86 83 86 83 83 86 83 86 83 83 86 83 86 83 83 86 83 86 83 83